1111111111111111111111111
100C00R000000000000R00001
100100000000R000000000001
1000000000000000CR0000001
100C0R0000000000000000001
10PC000000000000000000RE1
1111111111111111111111111
